######
#.   #
# #  #
###$ #
#. $@#
######